111111111111111111
111P000C0001111111
1111111111000E1111
011111111111111111
