111111111
10000001
1P0000001
1C0000011
1110000E1
111111111
