NO textures/big/NO.xpm
EA textures/big/EA.xpm
SO textures/big/SO.xpm
WE textures/big/WE.xpm

C 225,30,0
F 220,100,0





1111111111111111
1N001
10011
1000011
100001
1111111111111111