NO ./textures/cardinal/NO.xpm
SO ./textures/cardinal/SO.xpm
WE ./textures/cardinal/WE.xpm
EA ./textures/cardinal/EA.xpm

F 220,100,0
C 225,30,0


1111111111111111111
1000000000000000001
1010101010101010101
100N000000000000001
1010101010101010101
1000000000000000001
1010101010101010101
1000000000000000001
1111111111111111111