WE	blabla


  11111
111 0111
10101
11111
