NO textures/cardinal/NO.xpm


SO textures/cardinal/SO.xpm
WE textures/cardinal/WE.xpm
EA textures/cardinal/EA.xpm


F 220,100,1

C 225,30,0


1111111111111111
10001
10011
101S111
10010N1
11111111111111111