NO textures/cardinal/NO.xpm
NO textures/cardinal/NO.xpm


SO textures/cardinal/SO.xpm
WE textures/cardinal/WE.xpm
EA textures/cardinal/EA.xpm




F 255,0,0



C 0,255,0

1111111111111111
10001
10001
10S0111
1000001
11111111111111111
