NO textures/cardinal/NO.xpm

SO textures/cardinal/SO.xpm

WE textures/cardinal/WE.xpm

EA textures/cardinal/EA.xpm

F 220,100,222
C 225,30,0

111111111111111111
1000000            1
100111111111111111
1010111
10010N1
11111111111111111
