WE	blabla

 11111
111 0N111
10101
11111
