NO textures/cardinal/NO.xpm
SO textures/cardinal/SO.xpm
WE textures/cardinal/WE.xpm
EA textures/cardinal/EA.xpm

F 220,100,1
C 225,30,0

1111111111111111
10001
10001
1000011
1001001
11111111111111111
