NO textures/cardinal/NO.xpm
SO textures/cardinal/SO.xpm
WE textures/cardinal/WE.xpm
EA textures/cardinal/EA.xpm

F 255,0,0
C 0,255,0

101111111111111
111111111100001
111000000000000001
10S0111
10000001111111111
10000000000000001
11111111111111111