NO textures/cardinal/NO.xpm
SO textures/cardinal/SO.xpm
WE textures/cardinal/WE.xpm
EA textures/cardinal/EA.xpm

F 220,100,1
C 225,30,0


1101111
1101101
11N1111
1111111
