NO textures/64/NO.xpm
SO textures/64/SO.xpm
WE textures/64/WE.xpm
EA textures/64/EA.xpm

F 220,100,1
C 225,30,0

111111111111111111111111
1000001
10000111
100S00011
100000001
111111111
1111111111
11111111111111111
1 1 1 1 1 1 1 1 1