11111111111111111
10000000100000001
1C1101101011011C1
10000000C00000001
10110101110101101
10000100100100001
11110110101101111
11110100P00101111
1C000001E100000C1
11110100000101111
11110101110101111
10000000100000001
10110110101101101
1C010000C000010C1
11010101110101011
10000100100100001
10111110101111101
1C0000000000000C1
11111111111111111
