1111111111
1000C00001
1P00000001
1C00G00011
11100000E1
1111111111
