1111111111
1000C00101
1P00101001
1C00111111
11100001E1
1111111111
