1111111111
1000C00001
1P00000001
1C00000011
1110000001
1111111111
