11111111111111111
10000000100000001
1C1101101011011C1
10000000000000001
10110101110101101
10G00100100100001
11110110101101111
1111G100P00101111
10000001E10000001
11110100000101111
11110101110101111
10000000100000001
10110110101101101
1C010000C000010C1
11010101110101011
10G0010010010G001
10111110101111101
10000000000000001
11111111111111111
