111111111
1111111E1
1111111C1
111PCCCC1
111111111