11111111111111111111111111111111111111111111111111111111111111111111111111111111
1P0000000000000000000000000000000000000000000000000000000C1111111010100011111111
11111111111111111111111111111011111111111111111111111111111111111010111011111111
10000000000000000000000000000000000000000000000000000000001111111000110111111111
111111111111111111111111111CCC11111111111111111111111111111111111110101111111111
10000000000000000000000000000000000000000000000000000000001111111110100011111111
11111111CC1111111111111111111111111111111111111111111111111111111111111111111111
10000000000000000000000000000000000000000000000000000000001111111111111111111111
1C111111111111111111111111111111111111111111111111111111111111111111111111111111
10000000000000000000000000000000000000000000000000000000001111111111111111111111
11111111111111111111111C11111111111111111111111111111111111111111111111111111111
10000000000000000000000000000000000000000000000000000000001111111111111111111111
1111111111C111111111111111111111111111111111111111111111111111111111111111111111
10000000000000000000000000000000000000000000000000000000001111111111111111111111
111111111C1111111111111111111111111111111111111111111111111111111111111111111111
10000000000000000000000000000000000000000000000000000000001111111111111111111111
11111111111111111111111111111C1111111111111C111111111111111111111111111111111111
10000000000000000000000000000000000000000000000000000000001111111111111111111111
1111111111111111111111111111111111111111111C111111111111111111111111111111111111
10000000000000000000000000000000000000000000000000000000001111111111111111111111
1111111111111C111111111111111111111111111111111111111111111111111111111111111111
100000000000000000000000000000C000C000000000000000000000001111111111111111111111
111111111111C1111111111111111111111111111111111111111111111111111111111111111111
10000000000000000000000000000000000000000000000000000000001111111111111111111111
111111111111111111111111111111111111111111111111111C1111111111111111111111111111
10000000000000000000000000000000000000000000000000000000001111111111111111111111
11111111111111111111111111111111111C11111111111111111111111111111111111111111111
1C0000000000000000000000000000000000000000000000000C00000C1111111111111111111111
11111111111111111111111111111C11111111111111111111111111111111111111111111111111
100000000000000000000000000000C000C000000000000000000000001111111111111111111111
111111111111C1111111111111111111111111111111111111111111111111111111111111111111
10000000000000000000000000000000000000000000000000000000001111111111111111111111
111111111111111111111111111111111111111111111111111C1111111111111111111111111111
10000000000000000000000000000000000000000000000000000000001111111111111111111111
11111111111111111111111111111111111C11111111111111111111111111111111111111111111
1C0000000000000000000000000000000000000000000000000C00000C1111111111111111111111
11111111111111111111111111111C11111111111111111111111111111111111111111111111111
100000000000000000000000000000C000C000000000000000000000001111111111111111111111
111111111111C1111111111111111111111111111111111111111111111111111111111111111111
10000000000000000000000000000000000000000000000000000000001111111111111111111111
111111111111111111111111111111111111111111111111111C1111111111111111111111111111
10000000000000000000000000000000000000000000000000000000001111111111111111111111
11111111111111111111111111111111111C11111111111111111111111111111111111111111111
1C0000000000000000000000000000000000000000000000000C00000C1111111111111111111111
11111111111111111111111111111C11111111111111111111111111111111111111111111111111
1EC000000000000000000000000000000000000000000000000C00000C1111111111111111111111
11111111111111111111111111111C11111111111111111111111111111111111111111111111111
11111111111111111111111111111111111111111111111111111111111111111111111111111111
11111111111111111111111111111111111111111111111111111111111111111111111111111111
11111111111111111111111111111111111111111111111111111111111111111111111111111111
