111111111111111111111111111111111111111111111111111111111111
1P0000000000000000000000000000000000000000000000000000000C11
111111111111111111111111111110111111111111111111111111111111
100000000000000000000000000000000000000000000000000000000011
111111111111111111111111111CCC111111111111111111111111111111
100000000000000000000000000000000000000000000000000000000011
11111111CC11111111111111111111111111111111111111111111111111
100000000000000000000000000000000000000000000000000000000011
1C1111111111111111111111111111111111111111111111111111111111
100000000000000000000000000000000000000000000000000000000011
11111111111111111111111C111111111111111111111111111111111111
100000000000000000000000000000000000000000000000000000000011
1111111111C1111111111111111111111111111111111111111111111111
100000000000000000000000000000000000000000000000000000000011
111111111C11111111111111111111111111111111111111111111111111
100000000000000000000000000000000000000000000000000000000011
11111111111111111111111111111C1111111111111C1111111111111111
100000000000000000000000000000000000000000000000000000000011
1111111111111111111111111111111111111111111C1111111111111111
100000000000000000000000000000000000000000000000000000000011
1111111111111C1111111111111111111111111111111111111111111111
100000000000000000000000000000C000C0000000000000000000000011
111111111111C11111111111111111111111111111111111111111111111
100000000000000000000000000000000000000000000000000000000011
111111111111111111111111111111111111111111111111111C11111111
100000000000000000000000000000000000000000000000000000000011
11111111111111111111111111111111111C111111111111111111111111
1C0000000000000000000000000000000000000000000000000C00000C11
11111111111111111111111111111C111111111111111111111111111111
100000000000000000000000000000C000C0000000000000000000000011
1EC000000000000000000000000000000000000000000000000C00000C11
11111111111111111111111111111C111111111111111111111111111111
111111111111111111111111111111111111111111111111111111111111